+-----------------------------------------+
|                                         |
|          ##       #         #        #  |
|          ##                 #           |
|          ##                 #           |
|          ##                             |
|                  ##      ##             |
|       @    ##    ##      ##      M      |
|                  #        #             |
|       ##         #        #             |
|       # #        ##      ##        ##   |
|       # #                           #   |
|       # #      ##        ##        #    |
|       ###      #          #        #    |
|               #            #        #   |
|      ###      #            #            |
|                       ## ##      M      |
|         # #                       #     |
|         # #                       #     |
|         # #      ########         #     |
|         # #      #      #         #     |
|         # #      #      #         #     |
|                ##        ##             |
|                                         |
|       M                                 |
+-----------------------------------------+