+-----------------------------------------+
|                                         |
|          ..       .         .        .  |
|          ..                 .           |
|          ..                 .           |
|          ..                             |
|                  ..      ..             |
|       @    ..    ..      ..             |
|                  .        .             |
|       ..         .        .             |
|       . .        ..      ..        ..   |
|       . .                           .   |
|       . .      ..        ..        .    |
|       ...      .          .        .    |
|               .            .        .   |
|      ...      .            .            |
|                       .. ..             |
|         . .                       .     |
|         . .                       .     |
|         . .      ........         .     |
|         . .      .      .         .     |
|         . .      .      .         .     |
|                ..        ..             |
|                                         |
|                                         |
+-----------------------------------------+
